111111111111111111111111111
1E0000000000000000000000011
100010001110001110011110011
100110000010000010000010011
100010000100000100000100011
100010000010000010001000011
100111001110001110C10000011
1C0000000000000000000000P11
111111111111000111111111111
100010000010000010001000011
100111001110001110C10000011
1C0000000000000000000000011
111111111111111111111111111